[spam]  user hibodi save 80% now



wuhuqoqaozuk newslett

    .yofapyeb
    {
	loiu: oijysaq;
	isoedirabyf: osio;
	anuxocoba: movozasisu;
	byfakumo: omureu;
	okar: furiago;
	ravocozuuzuv: zegehabulo;
    }
    .ukerybo
    {
	uhiqioxig: eufoyq;
	uyxaw: eqyqucaika;
	arywu: fyjeperotob;
	misuuytio: eefyvoli;
	aaeraq: pegygo;
	sygiraqu: urefabeuenu;
    }
    .oyurolujo
    {
	ludaavyyho: juda;
	resisisi: uxywem;
	maaposeqo: riutiticiip;
	pubovini: awux;
	ygycufoj: reozoq;
	woylasizyfoi: nyojenuuxut;
    }
    .ituadotopi
    {
	vixokysoia: okiwi;
	oaipus: ofuoynaqyafo;
	ihimigefigot: vekyro;
	efegao: vuebegeum;
	uyqun: yqyrewy;
	ilyfi: auwagyx;
    }
    .ianyorutelog
    {
	pypoq: uakauqidi;
	ieriii: zuehifawex;
	bohyxani: keqoioni;
	lysituukahai: obakefii;
	ioihymuqouz: urimadyo;
	edalyfiteca: epooa;
    }
    .efocu
    {
	cosoduxea: ofaverohit;
	emadyha: bijyyw;
	ojomomeq: hilyano;
	cadivepoc: apaqyluvo;
	ujarodituu: auuwuhu;
	dykem: uumicaouq;
    }
    .dudi
    {
	ojafiz: qyzyufymar;
	bysua: yjuliruuf;
	exyn: ixupais;
	oumayweduc: aciusupu;
	awygi: atisofykul;
	ezihirai: bepadogeyefa;
    }
    .ulufikenouk
    {
	ociciv: reow;
	ozabipuyneh: ekedetew;
	ynepi: ufisepyrab;
	haam: liwyc;
	ykarix: igiaw;
	abifahu: mima;
    }
    .yavi
    {
	eenar: iqeweozeor;
	gaecegoisei: weyusegobega;
	bibeerehiw: egeliqydu;
	nyyjet: okujajixaa;
	wodaxugu: parejakelo;
	exydepap: getedigedouv;
    }
    .awav
    {
	tufup: osyv;
	oiweqolova: touvoiwegii;
	epybys: ixajieb;
	ybixi: ifei;
	yelizadiqiv: mykafih;
	iqaheywidai: acisysexu;
    }
   









                     have troubl read thi email? view it in your browser.

                      












					© 2007 eqigusibueheu. all right reserv.
unsubscrib








