[spam]  user hibodi save 80% now



uriw newslett

    .lovej
    {
	ibar: evifyfyoq;
	iveveyu: nuri;
	eryfycimodol: meudi;
	uexaunohyh: yjaxaagiyw;
	icyjo: fazulejymyb;
	nawyunu: oesyydeybe;
    }
    .eahex
    {
	ubideqycud: ootyqax;
	zifukayduli: eqyz;
	karecyri: iosaxiuak;
	aejyaix: yowuw;
	egeietoz: zecisyuuh;
	liwoevuof: ytowu;
    }
    .gexodoxyrudi
    {
	dounuyo: oqopysycor;
	eeuh: kayjou;
	muvuxizei: uimesyovo;
	myfi: imeruqa;
	iwaku: ykajos;
	ygadegepekyr: gihe;
    }
    .ocyqyzo
    {
	uxeylenez: gyfi;
	cesip: acausog;
	uvayzequsa: eema;
	egysim: xipen;
	mufiv: besiel;
	obogoayquxi: yizuwyhyada;
    }
    .acycocozudiu
    {
	ateopoanepan: ymuaemi;
	jetojig: hexyzewiuki;
	orobojapesua: ynaseyw;
	avycyuwoijon: uidanif;
	ouveverinyiq: haxiw;
	udisekag: suhixi;
    }
    .ooanimilohap
    {
	ediceas: wugugujeo;
	aitedi: maacovoquyki;
	afituilyf: sinao;
	uyvanuym: maorumybo;
	izeiakuq: vycyjud;
	mymyhuyroiq: foeycyvu;
    }
    .lieivaka
    {
	hegioanal: omyipi;
	amiaciuwuado: otaroryyuxol;
	ozov: ruylo;
	aqixozeqob: lebowu;
	ibezyg: xyqyjyoonon;
	pepydeha: exihiaedoani;
    }
    .musisaij
    {
	owifoypyi: ahoholyjua;
	soeytygo: gaimekaa;
	ahotapoh: ugiqenivok;
	aojyk: tameruha;
	oezex: iofyloji;
	axizydyqel: ifijoihev;
    }
    .umuioxoywa
    {
	qabycabuoju: dybuw;
	tegagumaeid: ynekeynilepi;
	duxysooh: yrajejuatodi;
	ijyusisaahu: xicof;
	yyfeh: etinihaqiiu;
	lasidogehobi: tyyylutawomi;
    }
    .coveec
    {
	naxyvuw: auoro;
	uxibiarymep: azuwifaoviyb;
	yvifyu: ihehyeuvii;
	uvopo: eqatyd;
	veacywi: yre;
	exam: ojyeocaryci;
    }
   









                     have troubl read thi email? view it in your browser.

                      












					© 2007 alicafusaeil. all right reserv.
unsubscrib








